NO ./textures/north_wall.xpm
SO ./textures/south_wall.xpm
WE ./textures/west_wall.xpm
EA ./textures/east_wall.xpm

F 255,128,0
C 70,130,180


111111111111111111111111111111111111111111111111111
100000000000000000000000000000000000000000000000001
100000000000000000000000000000000000000000000000001
100000111111111111111111111111111111111111111000001
100000100000000000000000000000000000000000001000001
100000100000000000000000000000000000000000001000001
100000100000111111111111111111111111111000001000001
100000100000100000000000000000000000001000001000001
100000100000100000000000000000000000001000001000001
100000100000100000000000000000000000001000001000001
100000100000100000111111111111111000001000001000001
100000100000100000100000000000001000001000001000001
100000100000100000100000000000001000001000001000001
100000100000100000100000W00000001000001000001000001
100000100000100000100000000000001000001000001000001
100000100000100000100000000000001000001000001000001
100000100000100000111111111111111000001000001000001
100000100000100000000000000000000000001000001000001
100000100000100000000000000000000000001000001000001
100000100000100000000000000000000000001000001000001
100000100000111111111111111111111111111000001000001
100000100000000000000000000000000000000000001000001
100000100000000000000000000000000000000000001000001
100000111111111111111111111111111111111111111000001
100000000000000000000000000000000000000000000000001
100000000000000000000000000000000000000000000000001
111111111111111111111111111111111111111111111111111
