NO ./textures/north_wall.xpm
SO ./textures/south_wall.xpm
WE ./textures/west_wall.xpm
EA ./textures/east_wall.xpm

F 100,50,200
C 135,206,235


        1111111111111111111111111111111111
        1000000000000000000000000000000001
        1000000000000000000000000000000001
        1000000111111111111111111100000001
        1000000100000000000000000100000001
        1000000100000000000000000100000001
        1000000100000111111110000100000001
        1000000100000100000010000100000001
        1000000100000100000010000100000001
        1000000100000100N00010000100000001
        1000000100000100000010000100000001
        1000000100000100000010000100000001
        1000000100000111111110000100000001
        1000000100000000000000000100000001
        1000000100000000000000000100000001
        1000000111111111111111111100000001
        1000000000000000000000000000000001
        1000000000000000000000000000000001
        1111111111111111111111111111111111
