NO ./textures/north_wall.xpm
SO ./textures/south_wall.xpm
WE ./textures/west_wall.xpm
EA ./textures/east_wall.xpm


F 220,100,0
C 225,30,0

1111111111111111111
1110000000011101111
11110111110111011S1
1111011001000001001
110000001 10001 101
1000000001001011101
1111111111111111111
