NO ./textures/north_wall.xpm
SO ./textures/south_wall.xpm
WE ./textures/west_wall.xpm
EA ./textures/east_wall.xpm


F 220,100,0
C 225,30,0

1111111111111111111
1110000000011101111
11110111110111011S1
1111011001000000001
110000001 100000001
1000000001001010101
1111111111111111111
