NO ./textures/north_wall.xpm
SO ./textures/south_wall.xpm
WE ./textures/west_wall.xpm
EA ./textures/east_wall.xpm

F 200,100,50
C 25,25,112


1111111111111111111111111111111111111111111111111111111111111111111111111111111111
1000000000000000000000000000000000000000000000000000000000000000000000000000000001
1000000000000000000000000000000000000000000000000000000000000000000000000000000001
1000000000000000000000000000000000000000000000000000000000000000000000000000000001
1001111111111111111111111111111111111111111111111111111111111111111111111111111001
1001000000000000000000000000000000000000000000000000000000000000000000000000001001
1001000000000000000000000000000000000000000000000000000000000000000000000000001001
1001000000000000000000000000000000000000000000000000000000000000000000000000001001
1001000111111111111111111111111111111111111111111111111111111111111111111000001001
1001000100000000000000000000000000000000000000000000000000000000000000001000001001
1001000100000000000000000000000000000000000000000000000000000000000000001000001001
1001000100000000000000000000000000000000000000000000000000000000000000001000001001
1001000100000000000000000000000000000000000000000000000000000000000000001000001001
1001000100000111111111111111111111111111111111111111111111111111111000001000001001
1001000100000100000000000000000000000000000000000000000000000000001000001000001001
1001000100000100000000000000000000000000000000000000000000000000001000001000001001
1001000100000100000000000000000000000000000000000000000000000000001000001000001001
1001000100000100000000000000000000000000000000000000000000000000001000001000001001
1001000100000100000000000000000000000000000000000000000000000000001000001000001001
1001000100000100000000000000000000000000000000000000000000000000001000001000001001
1001000100000100000000000000000000000000000000000000000000000000001000001000001001
1001000100000100000000000000000000000000000000000000000000000000001000001000001001
1001000100000100000000000000000000000000000000000000000000000000001000001000001001
1001000100000100000000000000000000000S00000000000000000000000000001000001000001001
1001000100000100000000000000000000000000000000000000000000000000001000001000001001
1001000100000100000000000000000000000000000000000000000000000000001000001000001001
1001000100000100000000000000000000000000000000000000000000000000001000001000001001
1001000100000100000000000000000000000000000000000000000000000000001000001000001001
1001000100000100000000000000000000000000000000000000000000000000001000001000001001
1001000100000100000000000000000000000000000000000000000000000000001000001000001001
1001000100000100000000000000000000000000000000000000000000000000001000001000001001
1001000100000100000000000000000000000000000000000000000000000000001000001000001001
1001000100000111111111111111111111111111111111111111111111111111111000001000001001
1001000100000000000000000000000000000000000000000000000000000000000000001000001001
1001000100000000000000000000000000000000000000000000000000000000000000001000001001
1001000100000000000000000000000000000000000000000000000000000000000000001000001001
1001000100000000000000000000000000000000000000000000000000000000000000001000001001
1001000111111111111111111111111111111111111111111111111111111111111111111000001001
1001000000000000000000000000000000000000000000000000000000000000000000000000001001
1001000000000000000000000000000000000000000000000000000000000000000000000000001001
1001000000000000000000000000000000000000000000000000000000000000000000000000001001
1001111111111111111111111111111111111111111111111111111111111111111111111111111001
1000000000000000000000000000000000000000000000000000000000000000000000000000000001
1000000000000000000000000000000000000000000000000000000000000000000000000000000001
1000000000000000000000000000000000000000000000000000000000000000000000000000000001
1111111111111111111111111111111111111111111111111111111111111111111111111111111111
