



NO ./textures/north_wall.xpm



SO					./textures/south_wall.xpm          					


WE ./textures/west_wall.xpm 

							EA ./textures/east_wall.xpm 

F 								220,              100,0
C 225								,30,												0

				1111111111111111111111111
				1000000000110000000000001
				1011000001110000000000001
				1001000000000000000000001
111111111011000001110000000000001
100000000011000001110111111111111
111101111111110111000000100010
1000000001100000010001
10000000000000001101010010001
                   N
1100000111010101111101111000111
11110111 1110101 101111010001
11111111 1111111 111111111111
