NO ./textures/north_wall.xpm
SO ./textures/south_wall.xpm
WE ./textures/west_wall.xpm 
      EA		    	./textures/east_wall.xpm 


F 220,              100               ,0
C 225,30,0

       11111111111111111111111111
       11111111111111111100011111
       11111111111111111100011111
       11111111111111111100011111
        1000000000110000000000001
        1011000001110000000000001
        1001000000000000000000001
111111111011000001110000000000001
100000000011000001110111110111111
11110111111111011100000010001
11110111111111011101010010001
11000000110101011100000000001
10000000000000001100000010N01
10000000000000001101010010001
1100000111010101111101111000111
11110111 1110101 101111010001
11111111 1111111 111111110001
                        10001
                        10001
                        11111