NO ./textures/north_wall.xpm
SO ./textures/south_wall.xpm
WE ./textures/west_wall.xpm 
      EA		    	./textures/east_wall.xpm 


F 220,              100               ,0
C 225,30,0

111111111111111111111111111111111111
111111000000000000000000000000111111
111110000000000000000000000000011111
111100000000000000000000000000001111
1110000000W0000000000000000000000111
110000000000000000000000000000000011
100000000000000000000000000000000001
100000000000000000000000000000000001
100000000000000000000000000011000001
100000000000010000000000000011000001
100000000000000000000000000000000001
100000000000000000000000000000000001
100000000000000000000000000000000001
100000000000000000000000000011000001
100000000000000000000000000011000001
110000000000000000000000000000000011
111000000000000000000000000000000111
111100000000000000000000000000001111
111110000010000000000000010000011111
111111000000000000000000000000111111
111111100000000000100000000001111111
111111110001000000000000000011111111
111111111000000000000001000111111111
111111111100000000000000001111111111
111111111110000000000000011111111111
111111111111000000000000111111111111
111111111111100000000001111111111111
111111111111111111111111111111111111

