NO ./textures/north_wall.xpm
SO ./textures/south_wall.xpm
WE ./textures/west_wall.xpm 
      EA		    	./textures/east_wall.xpm 


F 220,              100               ,0
C 225,30,0

111111111111111111111
111111000000000111111
111110000000000011111
111100000000000001111
1110000000N0000000111
110000000000000000011
100000000000000000001
100000011111110000001
100000011111110000001
100000000000010000001
100000000000000000001
100000000000010000001
100000011111110000001
100000011111110000001
100000000000000000001
110000000000000000011
111000000000000000111
111100000000000001111
111110000000000011111
111111000000000111111
111111111111111111111

