NO ./textures/north_wall.xpm
SO ./textures/south_wall.xpm
WE ./textures/west_wall.xpm
EA ./textures/east_wall.xpm

F 128,64,0
C 173,216,230


11111111111111111111111111111111111111111
10000000000000000000000000000000000000001
10000000000000000000000000000000000000001
10000111111111111111111111111111111000001
10000100000000000000000000000000001000001
10000100000000000000000000000000001000001
10000100001111111111111111111000001000001
10000100001000000000000000001000001000001
10000100001000000000000000001000001000001
10000100001000001111111000001000001000001
10000100001000001000001000001000001000001
10000100001000001000001000001000001000001
10000100001000001000001000001000001000001
10000100001000001000E01000001000001000001
10000100001000001000001000001000001000001
10000100001000001000001000001000001000001
10000100001000001111111000001000001000001
10000100001000000000000000001000001000001
10000100001000000000000000001000001000001
10000100001111111111111111111000001000001
10000100000000000000000000000000001000001
10000100000000000000000000000000001000001
10000111111111111111111111111111111000001
10000000000000000000000000000000000000001
10000000000000000000000000000000000000001
11111111111111111111111111111111111111111
