NO ./textures/north_wall.xpm
SO ./textures/south_wall.xpm
WE ./textures/west_wall.xpm
EA ./textures/east_wall.xpm

F 200,100,50
C 135,206,235


111111111111111111111111111111
1                            1
1                            1
1     000000000000000        1
1     0             0        1
1     0             0        1
1     0      S      0        1
1     0             0        1
1     0             0        1
1     000000000000000        1
1                            1
1                            1
1   00000000    00000000     1
1   0      0    0      0     1
1   0      0    0      0     1
1   0      0    0      0     1
1   00000000    00000000     1
1                            1
1                            1
1                            1
111111111111111111111111111111
