NO ./textures/north_wall.xpm
SO ./textures/south_wall.xpm
WE ./textures/west_wall.xpm
EA ./textures/east_wall.xpm

F 120,120,120
C 30,30,59
                     1
1111111111111111111111111E101111
                         1
