NO textures/bluestone.xpm
EA textures/purplestone.xpm
SO textures/eagle.xpm


F 0,0,12
C 200,200,20
WE textures/sky_1.xpm

        1111111111111111111111111
        1000000000110000000000001
        1011000001110000000000001
        1001000000000000000000001
        1011000001110000000000001
        1001000000000000000000001
        1011000001110000000000001
        1001000000000000000000001
        1011000001110000000000001
        1001000000000000000000001
        1011000001110000000000001
        1001000000000000000000001
        1011000001110000000000001
        1001000000000000000000001
        1011000001110000000000001
        1001000000000000000000001
        1011000001110000000000001
        1001000000000000000000001
        1011000001110000000000001
        1001000000000000000000001
        1011000001110000000000001
        1001000000000000000000001
        1011000001110000000000001
        1001000000000000000000001
        1011000001110000000000001
        1001000000000000000000001
        1011000001110000000000001
        1001000000000000000000001
        1011000001110000000000001
        1001000000000000000000001
        1011000001110000000000001
        1001000000000000000000001
        1011000001110000000000001
        1001000000000000000000001
        1011000001110000000000001
        1001000000000000000000001
        1011000001110000000000001
        1001000000000000000000001
        1011000001110000000000001
        1001000000000000000000001
        1011000001110000000000001
        1001000000000000000000001
        1011000001110000000000001
        1001000000000000000000001
        1011000001110000000000001
        1001000000000000000000001
        1011000001110000000000001
        1001000000000000000000001
        1011000001110000000000001
        1001000000000000000000001
        1011000001110000000000001
        1001000000000000000000001
        1011000001110000000000001
        1001000000000000000000001
        1011000001110000000000001
        1001000000000000000000001
        1011000001110000000000001
        1001000000000000000000001
        1011000001110000000000001
        1001000000000000000000001
        1011000001110000000000001
        1001000000000000000000001
        1011000001110000000000001
        1001000000000000000000001
        1011000001110000000000001
        1001000000000000000000001
        1011000001110000000000001
        1001000000000000000000001
        1011000001110000000000001
        1001000000000000000000001
        1011000001110000000000001
        1001000000000000000000001
        1011000001110000000000001
        1001000000000000000000001
        1011000001110000000000001
        1001000000000000000000001
        1011000001110000000000001
        1001000000000000000000001
        1011000001110000000000001
        1001000000000000000000001
        1011000001110000000000001
        1001000000000000000000001
        1011000001110000000000001
        1001000000000000000000001
        1011000001110000000000001
        1001000000000000000000001
        1011000001110000000000001
        1001000000000000000000001
        1011000001110000000000001
        1001000000000000000000001
        1011000001110000000000001
        1001000000000000000000001
        1011000001110000000000001
        1001000000000000000000001
        1011000001110000000000001
        1001000000000000000000001
        1011000001110000000000001
        1001000000000000000000001
        1011000001110000000000001
        1001000000000000000000001
        1011000001110000000000001
        1001000000000000000000001
        1011000001110000000000001
        1001000000000000000000001
        1011000001110000000000001
        1001000000000000000000001
        1011000001110000000000001
        1001000000000000000000001
        1011000001110000000000001
        1001000000000000000000001
        1011000001110000000000001
        1001000000000000000000001
        1011000001110000000000001
        1001000000000000000000001
        1011000001110000000000001
        1001000000000000000000001
        1011000001110000000000001
        1001000000000000000000001
        1011000001110000000000001
        1001000000000000000000001
        1011000001110000000000001
        1001000000000000000000001
        1011000001110000000000001
        1001000000000000000000001
        1011000001110000000000001
        1001000000000000000000001
        1011000001110000000000001
        1001000000000000000000001
        1011000001110000000000001
        1001000000000000000000001
        1011000001110000000000001
        1001000000000000000000001
        1011000001110000000000001
        1001000000000000000000001
        1011000001110000000000001
        1001000000000000000000001
        1011000001110000000000001
        1001000000000000000000001
        1011000001110000000000001
        1001000000000000000000001
        1011000001110000000000001
        1001000000000000000000001
        1011000001110000000000001
        1001000000000000000000001
        1011000001110000000000001
        1001000000000000000000001
        1011000001110000000000001
        1001000000000000000000001
        1011000001110000000000001
        1001000000000000000000001
        1011000001110000000000001
        1001000000000000000000001
        1011000001110000000000001
        1001000000000000000000001
        1011000001110000000000001
        1001000000000000000000001
        1011000001110000000000001
        1001000000000000000000001
        1011000001110000000000001
        1001000000000000000000001
        1011000001110000000000001
        1001000000000000000000001
        1011000001110000000000001
        100100000000000000000001
        1011000001110000000000001
        1001000000000000000000001
        1011000001110000000000001
        1001000000000000000000001
        1011000001110000000000001
        1001000000000000000000001
        1011000001110000000000001
        1001000000000000000000001
        1011000001110000000000001
        1001000000000000000000001
        101100000111000000000001
        1001000000000000000000001
        1011000001110000000000001
        1001000000000000000000001
        1011000001110000000000001
        1001000000000000000000001
        1011000001110000000000001
        1001000000000000000000001
        1011000001110000000000001
        1001000000000000000000001
        1011000001110000000000001
        1001000000000000000000001
        1011000001110000000000001
        1001000000000000000000001
        1011000001110000000000001
        1001000000000000000000001
        1011000001110000000000001
        1001000000000000000000001
        1011000001110000000000001
        1001000000000000000000001
        1011000001110000000000001
        1001000000000000000000001
        1011000001110000000000001
        1001000000000000000000001
        1011000001110000000000001
        1001000000000000000000001
        1011000001110000000000001
        1001000000000000000000001
        1011000001110000000000001
        1001000000000000000000001
        1011000001110000000000001
        1001000000000000000000001
        1011000001110000000000001
        1001000000000000000000001
        1011000001110000000000001
        1001000000000000000000001
        1011000001110000000000001
        1001000000000000000000001
        1011000001110000000000001
        1001000000000000000000001
        1011000001110000000000001
        1011000001110000000000001
        1011000001110000000000001
        1011000001110000000000001
        1011000001110000000000001
        1011000001110000000000001
        1011000001110000000000001
        1011000001110000000000001
        1011000001110000000000001
        1011000001110000000000001
        1011000001110000000000001
        1011000001110000000000001
        1011000001110000000000001
        1011000001110000000000001
        1011000001110000000000001
        1011000001110000000000001
        1011000001110000000000001
        1011000001110000000000001
        1011000001110000000000001
        1011000001110000000000001
        1011000001110000000000001
        1011000001110000000000001
        1011000001110000000000001
        1011000001110000000000001
        1011000001110000000000001
        1011000001110000000000001
        1011000001110000000000001
        1011000001110000000000001
        1011000001110000000000001
        1011000001110000000000001
        1011000001110000000000001
        1011000001110000000000001
        1011000001110000000000001
        1011000001110000000000001
        1011000001110000000000001
        1011000001110000000000001
        1011000001110000000000001
        1011000001110000000000001
        1011000001110000000000001
        1011000001110000000000001
        1011000001110000000000001
        1011000001110000000000001
        1011000001110000000000001
        1011000001110000000000001
        1011000001110000000000001
        1011000001110000000000001
        1111111111111111111111111
        1011000001110000000000001
        1001000000000000000000001
        1011000001110000000000001
        1001000000000000000000001
        1011000001110000000000001
        1001000000000000000000001
        1011000001110000000000001
        1001000000000000000000001
        1011000001110000000000001
        1001000000000000000000001
        1011000001110000000000001
        1001000000000000000000001
        1011000001110000000000001
        1001000000000000000000001
        1011000001110000000000001
        1001000000000000000000001
        1011000001110000000000001
        1001000000000000000000001
        1011000001110000000000001
        1001000000000000000000001
        1011000001110000000000001
        1001000000000000000000001
        1011000001110000000000001
        1001000000000000000000001
        1011000001110000000000001
        1001000000000000000000001
        1011000001110000000000001
        1001000000000000000000001
        1011000001110000000000001
        1001000000000000000000001
        1011000001110000000000001
        1001000000000000000000001
        1011000001110000000000001
        1001000000000000000000001
        1011000001110000000000001
        1001000000000000000000001
        1011000001110000000000001
        1001000000000000000000001
        1011000001110000000000001
        1001000000000000000000001
        1011000001110000000000001
        1001000000000000000000001
        1011000001110000000000001
        1001000000000000000000001
        1011000001110000000000001
        1001000000000000000000001
111111111011000001110000000000001
100000000011000001110111111111111
11110111111111011100000010001
11110111111111011101010010001
11000000110101011100000010001
100000000000000011000100010001
10000000000000001101010000001
11000001110101011111011110N0111
11111111 1111111 111111111111