NO ./textures/north_wall.xpm
SO ./textures/south_wall.xpm
WE ./textures/west_wall.xpm
EA ./textures/east_wall.xpm

F 120,120,120
C 30,30,59

11111111111111111111111111111111111111
1111111111111011111111111101111
11111111111111111111111111111111111111111111111111
1
1
11111111111111111111111111111111111111111111111111
1111111111111S0111111111011111111111
1111111111111111111111111111111111111111
1111111111111111111111111111111111111111111111111
111111111111111111111111111111111111111111111111
