NO ./textures/north_wall.xpm
SO ./textures/south_wall.xpm
WE ./textures/west_wall.xpm
EA ./textures/east_wall.xpm

F 220,100,0
C 225,30,0

1111111111111111
1      111     1
1     10001    1
1     10E01    1
1     10001    1
1111111111111111
