NO ./textures/north_wall.xpm
SO ./textures/south_wall.xpm
WE ./textures/west_wall.xpm
EA ./textures/east_wall.xpm

F 120,120,120
C 30,30,59

111111111111111111111111
100000000000000000000001
101111011111011111111101
101000010000010000000001
101011110111110111111101
1010000001000001000000E1
101011111101111101111101
100010000001000000000001
111110111101011111011111
100000100001000000100001
101111101111111110111101
1000001000001 1010000001
111111111111111111111111
